20 20
____XXXXXXXXXXXXXXXX
XXX_XXXXXXXXXXXXXXXX
XXX____XXXXXXXXXXXXX
XXXX__XXXXXXXXXXXXXX
XXXXX____XXXXXXXXXXX
XXXXXXXX_XXXXXXXXXXX
XXXXXXXX_XXXXXXXXXXX
XXXXXX_____XXXXXXXXX
XXXXXXXXXX___XXXXXXX
XXXXXXXXXXXX________
XXXXXXXXXXXXXXXXXXXX
XXXXXXXXXXXXXXXXXXXX
XXXXXXXXXXXXXXXXXXXX
XXXXXXXXXXXXXXXXXXXX
XXXXXXXXXXXXXXXXXXXX
XXXXXXXXXXXXXXXXXXXX
XXXXXXXXXXXXXXXXXXXX
XXXXXXXXXXXXXXXXXXXX
XXXXXXXXXXXXXXXXXXXX
XXXXXXXXXXXXXXXXXXXX